NO textures/bricks1.png

SO textures/bricks1.png
WE     textures/bricks2.png

D textures/door.png

          EA    textures/bricks2.png      


F     10,30,5
C    100,   30,   20


1111111111111111111111111
1000000000000000000000001
10111111000011D1110000001
1000000100000000010000001
1000W00101D11000010000001
1000000100001000011110001
1000000100001000000010001
1000000110001111000010001
1000000001000000000001001
1000000001000000001111001
1000000001111000000000001
100000000000111D110000001
1000000000000000000000001
1000000000000000000000001
1111111111111111111111111