
NO textures/text0.png

SO textures/text1.png
WE textures/text2.png



EA textures/text3.png


F 15,20,40

C 28,28,28


1111111111111111111111111
1000000000100010000111001
1000000000100010000111001
1000110000100010000111001
1001000000100010000111001
1000000000100010000000001
1000000000000000E00111001
1000000000100010000111001
1000010000100010000111001
1000000000100010000111001
1000000000100010000111001
1000010000100010000111001
1000000000100010000111001
1000000100100010000111001
1111111111111111111111111



1111111111111111111111111
1000000000000000000000001
1000000000000000000000001
1000000010000000000000001
1000000100000000000000001
1000000000000000000000001
100000000000S000000000001
1110000000000000000000001
1000000000000000000000001
1000000000000000000000001
1000000000000000000000001
1000000000000000000000001
1000000000000000000000001
1000000000000000000000001
1111111111111111111111111







        1111111111111111111111111
        1000000000110000000000001
        1011000001110000000000001
        1001000000000000000000001
111111111011000001110000000000001
100000000011000001110111111111111
11110111111111011100000010001
11110111111111011101010010001
11000000110101011100000010001
10011100000000001100000010001
10011100000000001101010010001
11011101110101011111011110N0111
11110111 1110101 101111010001
11111111 1111111 111111111111



      1111111 1111111
     11000001110000011
    1100000000S00000011
   110000011100000000011
   11000001 100001111111
    110000111000001
     11000001110001111111
      1111111 1111111



     1111111111111111
      11000000000111
       10000000001
      11001111110111
     111111    1111111

